. . . . . . . . . . . .
. n n n n n . n n . n .
. n n n n n . n n . n .
. . . T . . . . . . . .
. n n . n n n n . n n .
. n n . n n n n . n n .
. . . . . . . . . . . .
. n n . n n . n n n n .
. n n . n n . n n n n .
. n n . n n . n n n n .
. n n . n n . n n n n .
. . . . . . . . . . . D